NO             nord.h

SO   sud.h






EA   east.h
WE west.h
   F 0,   76,211         

C 16,255,    3         

11111111111111111111111111111111111111111 
11000000S00000000000000000000000000011111
111111111111111111111111111111111111111
