1111111111111111
10000N0P11C00C11
1N0N00N00110C0C1
1C0N000000000C01
1111011111111111
1E0N0N000N000001
1N0N000N0N000001
1N00NNN00N000001
10N00N00N0000001
100N000N00000001
1111111111111111